{
  "Instruction": "Please add more entry under the 'rooms' list, and make sure the width and heigh is Exactly the same(15x15), also, before commit, make sure this is a valid json file",
  "rooms": [{
    "tiles": [
      "#","#","#","#","#","#","#","#","#","#","#","#","#","#","#",
      "#",".",".",".",".",".",".",".",".",".",".",".",".",".","#",
      "#",".","#","#",".","#","#",".",".",".",".",".",".",".","#",
      "#",".","#",".",".",".","#",".",".",".",".",".",".",".","#",
      "#",".","#",".",".",".","#",".",".",".",".",".",".",".","#",
      "#",".","#",".",".",".","#",".",".",".",".",".",".",".","#",
      "#",".","#",".",".",".","#",".",".",".",".",".",".",".","#",
      "#",".","#",".",".",".","#",".",".",".",".",".",".",".","#",
      "#",".","#",".",".",".","#",".",".",".",".",".",".",".","#",
      "#",".","#",".",".",".","#",".",".",".",".",".",".",".","#",
      "#",".","#",".",".",".","#",".",".",".",".",".",".",".","#",
      "#",".","#",".",".",".","#",".",".",".",".",".",".",".","#",
      "#",".","#","#","#","#","#",".",".",".",".",".",".",".","#",
      "#",".",".",".",".",".",".",".",".",".",".",".",".",".","#",
      "#","#","#","#","#","#","#","#","#","#","#","#","#","#","#"
   ]
  }]
}
