{
  "Instruction": "Please add more entry under the 'rooms' list, and make sure the width and heigh is Exactly the same(15x15), also, before commit, make sure this is a valid json file",
  "IMPORTANT": "You must not block the hallway area in the hallway, and you mast keep the json formatting",
  "rooms": [{
    "tiles": [
      "#","#","#","#","#","#","#"," ","#","#","#","#","#","#","#",
      "#"," "," "," "," "," "," "," "," "," "," "," "," "," ","#",
      "#"," ","#","#"," ","#","#"," "," "," "," "," "," "," ","#",
      "#"," ","#"," "," "," ","#"," "," "," "," "," "," "," ","#",
      "#"," ","#"," "," "," ","#"," "," "," "," "," "," "," ","#",
      "#"," ","#"," "," "," ","#"," "," "," "," "," "," "," ","#",
      "#"," ","#"," "," "," ","#"," "," "," "," "," "," "," ","#",
      " "," ","#"," "," "," ","#"," "," "," "," "," "," "," "," ",
      "#"," ","#"," "," "," ","#"," "," "," "," "," "," "," ","#",
      "#"," ","#"," "," "," ","#"," "," "," "," "," "," "," ","#",
      "#"," ","#"," "," "," ","#"," "," "," "," "," "," "," ","#",
      "#"," ","#"," "," "," ","#"," "," "," "," "," "," "," ","#",
      "#"," ","#","#","#","#","#"," "," "," "," "," "," "," ","#",
      "#"," "," "," "," "," "," "," "," "," "," "," "," "," ","#",
      "#","#","#","#","#","#","#"," ","#","#","#","#","#","#","#"
   ]
  },
  {
    "tiles": [
      "#","#","#","#","#","#","#"," ","#","#","#","#","#","#","#",
      "#"," "," "," "," "," "," "," "," "," "," "," "," "," ","#",
      "#"," ","#","#"," ","#","#"," "," "," "," "," "," "," ","#",
      "#"," ","#"," "," "," ","#"," "," "," "," "," "," "," ","#",
      "#"," ","#"," "," "," ","#"," "," "," "," "," "," "," ","#",
      "#"," ","#"," "," "," ","#"," "," "," "," "," "," "," ","#",
      "#"," ","#"," "," "," ","#"," "," "," "," "," "," "," ","#",
      " "," ","#"," "," "," ","#"," "," "," "," "," "," "," "," ",
      "#"," ","#"," "," "," ","#"," "," "," "," "," "," "," ","#",
      "#"," ","#"," "," "," ","#"," "," "," "," "," "," "," ","#",
      "#"," ","#"," "," "," ","#"," "," "," "," "," "," "," ","#",
      "#"," ","#"," "," "," ","#"," "," "," "," "," "," "," ","#",
      "#"," ","#","#","#","#","#"," "," "," "," "," "," "," ","#",
      "#"," "," "," "," "," "," "," "," "," "," "," "," "," ","#",
      "#","#","#","#","#","#","#"," ","#","#","#","#","#","#","#"
   ]
  }
  ],
  "bossRooms": [
    {
     "tiles": [
        "#","#","#","#","#","#","#"," ","#","#","#","#","#","#","#",
        "#"," "," "," "," "," "," "," "," "," "," "," "," "," ","#",
        "#"," ","#","#"," ","#","#"," "," "," "," "," "," "," ","#",
        "#"," ","#"," "," "," ","#"," "," "," "," "," "," "," ","#",
        "#"," ","#"," "," "," ","#"," "," "," "," "," "," "," ","#",
        "#"," ","#"," "," "," ","#"," "," "," "," "," "," "," ","#",
        "#"," ","#"," "," "," ","#"," "," "," "," "," "," "," ","#",
        " "," ","#"," "," "," ","#"," "," "," "," "," "," "," "," ",
        "#"," ","#"," "," "," ","#"," "," "," "," "," "," "," ","#",
        "#"," ","#"," "," "," ","#"," "," "," "," "," "," "," ","#",
        "#"," ","#"," "," "," ","#"," "," "," "," "," "," "," ","#",
        "#"," ","#"," "," "," ","#"," "," "," "," "," "," "," ","#",
        "#"," ","#","#","#","#","#"," "," "," "," "," "," "," ","#",
        "#"," "," "," "," "," "," "," "," "," "," "," "," "," ","#",
        "#","#","#","#","#","#","#"," ","#","#","#","#","#","#","#"
      ]
    }
  ]
}
